...#######
..##.#.###
.##..###.#
##.......#
#...@..#.#
###..###.#
..#..#...#
.##.##.#.#
.#......##
.#.....###